x,x,x,x,x,x,x,x,x,x,x,x
x,,,,,,,,,,,x
x,,,,,,,,,,,x
x,,,,,,,,,,,x
x,,,,,,,,,,,x
x,,,,,,,,,,,x
x,,,,,,,,,,,x
x,,,,,,,s,S,,,x
x,,,,,,,,,,,x
x,,h,,,,,,,,,x
x,,,,,,,d,,,,x
x,x,x,x,x,x,x,x,x,x,x,x