x,x,x,x,x,x,x,x,x,x,x,x
x,w1,d,,,,,,,,w3,x
x,w1,,,,,,,,,w3,x
x,w1,,,,,,,,,w3,x
x,w1,,,,,,,,,w3,x
x,w1,,,,,,,,x,x,x
x,w1,,,,,,,,x,x,x
x,w1,,h,,,,,,x,x,x
x,w1,,,,,,,,x,x,x
x,x,x,x,x,x,x,x,x,x,x,x