x,x,x,x,x,x,x,x,x,x,x,x
x,o,o,o,o,o,o,o,o,o,o,x
x,o,o,o,o,o,o,o,o,o,o,x
x,o,o,o,o,o,o,o,o,o,o,x
x,o,o,o,o,o,o,o,o,o,o,x
x,o,o,o,o,o,o,o,o,o,o,x
x,o,o,o,o,o,o,o,o,o,o,x
x,o,o,o,o,o,o,o,o,o,o,x
x,o,o,o,o,o,o,o,o,o,o,x
x,o,s,o,o,o,o,o,o,o,o,x
x,o,o,o,o,o,w,w,o,o,d,x
x,x,x,x,x,x,x,x,x,x,x,x