x,x,x,x,x,x,x,x,x,x,x,x
x,,,,,,,,,,,x
x,,,,,,,,,,,x
x,,,,,,,,,,,x
x,,,,,,,,,,,x
x,,,,,,,,,,,x
x,,,,,,,,,,,x
x,,,,,,s,s,,,,x
x,,,,,,,,,,,x
x,,h,,,,,,,,,x
x,,,,,,,d,,,,x
x,x,x,x,x,x,x,x,x,x,x,x