x,x,x,x,x,x,x,x,x,x,x,x
x,,,,,,,,,,,x
x,,,,,,,,,,,x
x,,,,,,,S,,,,x
x,,,,,,,,,,,x
x,,,,,,,,,,,x
x,,,,,,,,,,,x
x,,,,,,,,,,,x
x,,,,,,,,,,,x
x,,h,,,,,,,,,x
x,,,,,,,d,,,,x
x,x,x,x,x,x,x,x,x,x,x,x