x,x,x,x,x,x,x,x,x,x,x,x
x,o,o,o,o,o,o,o,o,o,o,x
x,o,o,o,o,o,o,o,o,o,o,x
x,o,o,o,o,o,o,o,o,o,o,x
x,o,o,o,o,o,o,o,o,o,o,x
x,o,o,o,o,o,o,o,o,o,o,x
x,o,o,o,o,o,o,o,o,o,o,x
x,o,o,o,o,o,o,o,o,o,o,x
x,o,o,o,o,o,o,o,o,o,o,x
x,o,s,o,o,o,o,o,o,o,o,x
x,o,o,o,o,o,o,o,o,d,o,x
x,x,x,x,x,x,x,x,x,x,x,x