x,x,x,x,x,x,x,x,x,x,x,x
x,w1,d,,,,,,,,w3,x
x,w1,,,,,,,,,w3,x
x,w1,,,,,,,,,w3,x
x,w1,,,,,,,,,w3,x
x,w1,,,,,,,,x,x,x
x,w1,,,,,,,,x,x,x
x,w1,,h,,s,,s,s,x,x,x
x,w1,,,,,,,,x,x,x
x,x,x,x,x,x,x,x,x,x,x,x