x,x,x,x,x,x,x,x,x,x,x,x
x,w1,d,o,o,o,o,o,o,o,w3,x
x,w1,o,o,o,o,o,o,o,o,w3,x
x,w1,o,o,o,o,o,o,o,o,w3,x
x,w1,o,o,o,o,o,o,o,o,w3,x
x,w1,o,o,o,o,o,o,o,x,x,x
x,w1,o,o,o,o,o,o,o,x,x,x
x,w1,o,s,o,o,o,o,o,x,x,x
x,w1,o,o,o,o,o,o,o,x,x,x
x,x,x,x,x,x,x,x,x,x,x,x